########################################
#                                      #
#                                      #
#                                      #
#                  #                   #
#                  #                   #
#                  #                   #
#                  #                   #
#                  #                   #
#                  #                   #
#        ##        #         ##        #
#                  #                   #
#                  #                   #
#                  #                   #
#                  #                   #
#                  #                   #
#                  #                   #
#                  #                   #
#                  #                   #
#        ##        #         ##        #
#                  #                   #
#                  #                   #
#                  #                   #
#                  #                   #
#                  #                   #
#                  #                   #
#                                      #
#                                      #
#                                      #
########################################