###############################
#                             #
#             #         ####  #
#             #               #
#     #### ####       #       #
#     #       #       #       #
#     #       ###  ####       #
#             #               #
#  ####       #               #
#                             #
###############################