########################################
#                                      #
#                                      #
#        ########     ########         #
#                  #                   #
#                  #                   #
#      ######      #        ######     #
#                  #                   #
#                  #                   #
#                  #                   #
#        ##        #      #######  ##  #
#                  #      #            #
#                  #      #            #
#                  #      #            #
#           ###############            #
#                  #                   #
#    ##            #          ##       #
#                  #                   #
#                  #                   #
#        ##        #         ##        #
#                  #                   #
#                  #                   #
#                  #                   #
#      ######      #         ######    #
#                  #                   #
#                  #                   #
###########                    #########
#                                      #
#                                      #
########################################