##############################
#                            #
#             #              #
#             #              #
#             #              #
#     #       #      #       #
#             #              #
#             #              #
#             #              #
#                            #
##############################