###################
#                 #
# ### # ### # ### #
# #i# #     # #i# #
# ### # # # # ### #
#     # # # #     #
# ##### # # ##### #
# #             # #
# # ##### ##### # #
#                 #
# ##### ### ##### #
#       #i#       #
# ### # ### # ### #
# #i#q#     # #i# #
# ### # ### # ### #
#     # #i# #     #
# ##### ### ##### #
#                 #
###################